1111111111111
100C00000C001
1P01001100001
1C000C1C00001
1000C01001001
100C00E0C0001
1001010010001
10C0100C00001
1111111111111
