11111111
10C00001
1P0000E1
11111111
