11111111111
1000C000001
10100010001
10001000001
1000000C001
11111111111
