11111111
1P000E01
10C00001
11111111
