11111111111
10010000001
10100001001
10000100001
10100000001
11111111111
