11111
100P1
1C001
1C001
1E001
11111
