11111111111111
1P000000000001
10000000000001
10000000000001
11111111111111
11111111111111
10000000000001
10000000000001
10000000000001
10000000000001
11111111111111
10C00000000E01
11111111111111
