111111111
10E000C01
1C00C0001
10C0C0101
10C011001
1P0C10C01
111111111
