11111111
11P000C1
11101111
11C01CE1
11111111
