111111111
1P0E00001
1C0000001
100000001
100000001
100000001
111111111
