1111111111
10P0000001
1111110001
100CCC0001
1001111111
10000000E1
1111111111
