11111111
1C0000P1
11000001
1C0000E1
11111111
