11111111
11P11111
1000C001
11111011
10C00001
11110111
10000001
10111111
100000E1
11111111
