11111111
1C0CCCP1
11111101
10000001
100C0001
1100C001
1100C001
11E00001
11111111
