11111111
11P00001
11100001
1111C0E1
11111111
