11111111
1C0000P1
11000001
1C1C1E01
11111111
