11111111
1C0CCCP1
11111101
11E00001
11111111
