11111111
1C0P0001
11011111
1E01C001
11111111
