111111111
10CC1C101
10C000001
1C0001001
1CC001101
1P0E0C011
111111111
