11111111
1C1000P1
11000001
100000E1
11111111
