11111111
1C0P0001
10111101
100C00E1
11111111
