11111111
1C0CCCP1
111111E1
11C11001
11111111
