11111111
11P00001
11101111
11C010E1
11111111
