11111111
1C0000P1
111110E1
1C000001
11111111
