11111111
11PC00C1
11111111
11C0CCE1
11111111
