111111111
1CP0101C1
1C00000C1
1C00010C1
1C00011C1
1C0E0C0C1
111111111
